大佬爱摇滚 两位美国总统候选人透露最爱曲目
　　新浪娱乐讯 贝拉克·奥巴马(Barack Obama)和约翰·麦凯恩(John McCain)终于来到单挑阶段。近日，这两位美国总统候选人接受了《Blender》杂志的采访，并透露了他们的最爱摇滚曲目。
　　在刚刚结束的一轮会战热身中，奥巴马批评了他的好朋友、影音双栖饶舌歌手路达克里斯(Ludacris(听歌))。后者写歌不妥，错误地向“象王”约翰·麦凯恩发射不敬信号。
　　前车覆，后车戒。奥巴马吸取教训，一切以选战为中心，再接再厉。“驴王”最新的动作是，力邀英国灵魂创作歌手乔丝·斯通(Joss Stone(听歌))谱写奥氏竞选歌曲。
　　不过，在刚出炉的奥巴马酷爱名单上，并未出现这位德文郡籍歌手的名字。
　　来看看民主党候选人贝拉克·奥巴马的Top 10：
　　Fugees(听歌) - 'Ready Or Not'
　　Marvin Gaye(听歌) - 'What's Going On'
　　Bruce Springsteen(听歌) - 'I'm On Fire'
　　The Rolling Stones(听歌) - 'Gimme Shelter'
　　Nina Simone(听歌) - 'Sinnerman'
　　Kanye West(听歌) - 'Touch The Sky'
　　Frank Sinatra(听歌) - 'You'd Be So Easy To Love'
　　Aretha Franklin(听歌) - 'Think'
　　U2( 听歌) - 'City of Blinding Lights'
　　William - 'Yes We Can'
　　再来看看共和党候选人约翰·麦凯恩的Top 10：
　　ABBA( 听歌) - 'Dancing Queen'
　　Roy Orbison(听歌) - 'Blue Bayou'
　　ABBA - 'Take A Chance On Me'
　　Merle Haggard(听歌) - 'If We Make It Through December'
　　Dooley Wilson - 'As Time Goes By'
　　The Beach Boys(听歌) - 'Good Vibrations'
　　Louis Armstrong(听歌) - 'What A Wonderful World'
　　Frank Sinatra - 'I've Got You Under My Skin'
　　Neil Diamond(听歌) - 'Sweet Caroline'
　　The Platters(听歌) - 'Smoke Gets In Your Eyes'
　　看看他们各自的选择，你能否从中窥探到这两个人的内心和性格？今年11月4日，美国大选将进入最终摊牌状态。届时，无论是奥巴马还是麦凯恩，都会在决战美利坚之巅的同时，告诉人们谁才是真正“驴”模“象”样的摇滚青年。
　　鸭王/文
　　声明：新浪网独家稿件，转载请注明出处。

